NO texture/wall/text1.xpm
SO texture/wall/text2.xpm
WE texture/wall/text3.xpm
EA texture/wall/text4.xpm
F 40,40,40
C 10,10,60

11111111111111111111111111111111111111111111111111111111111111111111111111111111
10000000000000000000100000000000000000000000000000000000000000000000000000000001
10000W00001000000000100000000000000000000000000000000000000000000000000000000001
10000000010000000001000000000000000000000000100000000000000000000000000000000011
11111111111011111111100001111000001000000000010000000000000000000000000000000001
10000000000000000000100001  1000001000000000010000000000000000000000000000000001
10000000000000000000100001  10000010000000000100000000000000000000000000000000011111111
10000000000000000000100001  10000010000000000100000000000000010000000000000000000000001
100000000000000000001000011110000010000000000100000000000000000000000000000000011111101
10000000000000000000100000000000001000000000010000000000000000000000000000000001    101
111111100000000000001000000000000010000000000100000000000000000000000000000000011111101
      100000000000000000001111111111111110000000000000000000000000000000000000000000001
111111100000000000000100000000000010000000000000000000000000000000000000000000011111111
11111110000000000000000000000000000000000000000000000000000000000000000000000001
10000000010000000000000000000000000000000000000000000000000000000000000000000001
10000000010000000000000000000000000000000000000000000000000000000000000000000001
10000000010000000000000000000000000000000000000000000000000000000000000000000001
10000000010000000000000000000000000000000000000000000000000000000000000000000001
10000000010000000000000000000000000000000000000000000000000000000000001000000011
10000000010000000000000000000000000000000000000000000000000000000000000000000011
10000000010000000000000000000000000000000000000000000000000000000000000000000011
10000000000011110000000000000000000000000000000000000000000000000000000000000001
10000000000011110000000000000000000000000000000000000000000000000000000000000001
10000000010010000000000000000000000000000000000000000000000000000000000000000001
10000000010010000000000000000000000000000000000000000000000000000000000000000001
10000000010010000000000000000000000000000000000000000000000000000000000000000001
10000000010010000000000000000000000000000000000000000000000000000000000000000001
10000000010010000000000000000000000000000000000000000000000000000000001000000011
10000000010010000000000000000000000000000000000000000000000000000000000000000011
10000000000010000000000000000000000000000000000000000000000000000000000000000011
10000000011100000000000000000000000000000000000000000000000000000000000000000001
10000000011111111110000000000000000000000000000000000000000000000000000000000001
10000000000000000011111111000000000000000000000000000000000000000000000000000001
10000000000000000000000001000000000000000000000000000000000000000000000000000001
10000000011111111111111111000000000000000000000000000000000000000000000000000001
10000000010000000000000000000000000000000000000000000000000000000000001000000011
10000000010000000000000000000000000000000000000000000000000000000000000000000011
10000000010000000000000000000000000000000000000000000000000000000000000000000011
10000000010111110000000000000000000000000000000000000000000000000000000000000001
10000000010000000000000000000000000000000000000000000000000000000000000000000001
10000000010000000000000000000000000000000000000000000000000000000000000000000001
10000000010000000000000000000000000000000000000000000000000000000000000000000001
10000000010000000000000000000000000000000000000000000000000000000000000000000001
10000000010000000000000000000000000000000000000000000000000000000000001000000011
10000000010000000000000000000000000000000000000000000000000000000000000000000011
10000000010000000000000000000000000000000000000000000000000000000000000000000011
10000000010111110000000000000000000000000000000000000000000000000000000000000001
10000000010000000000000000000000000000000000000000000000000000000000000000000001
10000000010000000000000000000000000000000000000000000000000000000000000000000001
10000000010000000000000000000000000000000000000000000000000000000000000000000001
10000000010000000000000000000000000000000000000000000000000000000000000000000001
10000000010000000000000000000000000000000000000000000000000000000000001000000011
10000000010000000000000000000000000000000000000000000000000000000000000000000011
10000000010000000000000000000000000000000000000000000000000000000000000000000011
11111111111111111111111111111111111111111111111111111111111111111111111111111111